takephoto=拍照
browserphoto=浏览相册
take=处理
gallery=相册
back=返回
refresh=刷新
save=保存
faceProcessViewTitle=图像变身
next=下一步
faceRectangleViewTitle=标记脸
galleryViewTitle=相册
LoadingRpElementsViewTitle=读入元素...
photoPickViewTitle=选择照片
sharePhotoViewTitle=浏览照片
share=分享
photoZoomViewTitle=调整图片
Share2Weibo=分享到新浪微博
weiboLoginTitle=分享到新浪微博
Username=用户名
Password=密码
shareIt=登录分享
shareAllTitle=分享到
takeViewTitle=拍照
TypeSelectionViewTitle=加入元素
ToWeibo=分享到新浪微博
notice=提示
loging=登陆中...
cancle=取消
logFailed=登录失败
ok=确定
shareOk=分享成功
shareFailed=分享失败
transmiting=传输中...
options=设置
refresh=刷新
selecElements=选择素材
Elements=图片元素
ElementsDes=选择处理图像时出现的元素，如头饰、面具
PicProc=图片处理
PicProcDes=图片处理的相关效果
loading=读取中
demo=教程演示
home=首页
makeSureUsrPwd=用户名密码不能为空
makeSurePIN=请填入PIN码
pinFailed=PIN码错误
saySomething=说点什么吧.
limitWords=不能超过140字.
PIN=PIN码
defaultSettings=恢复默认配置
loadingSucc=载入成功
themedesc=选择主题包
theme=主题包
optionsViewTitle=选项
ImageProcessingOptionsViewTitle=处理过程
packageSelectViewTitle=主题包
