takephoto=Camera
browserphoto=Media
take=Do IT
gallery=Gallery
back=Back
refresh=Refresh
save=Save
faceProcessViewTitle=Geek Pic
next=Next
faceRectangleViewTitle=Pick Faces
galleryViewTitle=Gallery
LoadingRpElementsViewTitle=Loading Decorations
photoPickViewTitle=Pick a photo
sharePhotoViewTitle=Photo Viewer
share=Share
photoZoomViewTitle=Adjust
Share2Weibo=Share to Weibo
weiboLoginTitle=Share to Sina Weibo
Username=Username
Password=Password
shareIt=Share It
shareAllTitle=Share To?
takeViewTitle=Take Photo
TypeSelectionViewTitle=Elements
ToWeibo=To Sina Weibo
notice=Notice
loging=Loging...
cancle=Cancel
logFailed=Login Failed
ok=OK
shareOk=Shared
shareFailed=Sharing Failed
transmiting=Transmitting...
options=Options

refresh=Refresh
selecElements=Elements
Elements=Pic Elements
ElementsDes=Select the added picture elements
PicProc=Pic Process
PicProcDes=Effects of Pic dealing process
loading=Loading
demo=Demo
home=Home
makeSureUsrPwd=Lack of info...
makeSurePIN=Please type PIN Code
pinFailed=PIN Error
saySomething=Please say something.
limitWords=140 words limited.
PIN=PIN Code
defaultSettings=Roll Default
loadingSucc=Loading Success
themedesc=Select theme package
theme=Theme package
optionsViewTitle=Options
ImageProcessingOptionsViewTitle=Process
packageSelectViewTitle=Theme Package